BBBBBBBBBBBBBBBBBBBBBBBBB
BHDDDDDDDDDDDDDDDDBDDDDDB
BDDDDDDDDDDDDDDDDDBDDDDDB
BDDDDDDDDDDDDDDDDDBDDDDDB
BBBBBBBBBBDDDDDDDDBDDDDDB
BDDDBDRRDDDDDDDDDDBDDDDDB
BDDDBDRRDDDDDDDDDDBDDDDDB
BDDDBDDDDDDDDDDDDDDDDDDDB
BDDDBDDDDDDDDDDDDDDDDDDDB
BDDDBDDBBBBBDDDDRRRDDDDDB
BDDDDDDDDDDBDDDDDDRDDDDDB
BDDDDDDDDDDBDDDDDDRRRRDDB
BDDDDDDDDDDBDDDDDDDDVDDDB
BVDDDDDDDDDBDDDDDDDDDDDDB
BBBBBBBBBBBBDDDDDDDDDDDDB
BDDDDDDDDDDDDDDDDDDDDDDDB
BDDDDDDDDDDDDDDDDDDDDDDEB
BDDDDDDDDDDDDDDDDDDDDDDDB
BDDDDDDDDDDDDDDDDDDDDDDDB
BDDDDDDDDDDDDDDDDDBBBBBBB
BDDDDDDDDDDDDDDDDDBDRRDVB
BDDDDDDDDDDDDDDDDDBDRRDDB
BDDDDDDDRRRRRDDDDDBDRRDDB
BDDDDDDDRRDDRDDDDDBDDDDDB
BDDDDDDDRRVDRDDDDDDDDDDDB
BDDDDDDDDDDDDDDDDDDDDDDDB
BDDDDDDDDDDDDDDDDDDDDDDDB
BBBBBBBBBBBBBBBBBBBBBBBBB
