XXXXXXXXXXXXXXXXXXXXXXXXX
XHDDDDDDDDDDDDDDDDXDDDDDX
XDDDDDDDDDDDDDDDDDXDDDDDX
XDDDDDDDDDDDDDDDDDXDDDDDX
XXXXXXXXXXDDDDDDDDXDDDDDX
XDDDXDRRDDDDDDDDDDXDDDDDX
XDDDXDRRDDDDDDDDDDXDDDDDX
XDDDXDDDDDDDDDDDDDDDDDDDX
XDDDXDDDDDDDDDDDDDDDDDDDX
XDDDXDDXXXXXDDDDRRRDDDDDX
XDDDDDDDDDDXDDDDDDRDDDDDX
XDDDDDDDDDDXDDDDDDRRRRDDX
XDDDDDDDDDDXDDDDDDDDVDDDX
XVDDDDDDDDDXDDDDDDDDDDDDX
XXXXXXXXXXXXDDDDDDDDDDDDX
XDDDDDDDDDDDDDDDDDDDDDDDX
XDDDDDDDDDDDDDDDDDDDDDDEX
XDDDDDDDDDDDDDDDDDDDDDDDX
XDDDDDDDDDDDDDDDDDDDDDDDX
XDDDDDDDDDDDDDDDDDXXXXXXX
XDDDDDDDDDDDDDDDDDXDRRDVX
XDDDDDDDDDDDDDDDDDXDRRDDX
XDDDDDDDRRRRRDDDDDXDRRDDX
XDDDDDDDRRDDRDDDDDXDDDDDX
XDDDDDDDRRVDRDDDDDDDDDDDX
XDDDDDDDDDDDDDDDDDDDDDDDX
XDDDDDDDDDDDDDDDDDDDDDDDX
XXXXXXXXXXXXXXXXXXXXXXXXX
