BBBBBBBBBBBBBBBBBBBBBBBBB
BDDDDDDDDDDDDDDDDDDDDDDDB
BBBBBBBBBBDBBBBBBBBDDDDDB
BDDDDDDDVBDBVDDDDDBDDDDDB
BDDDDDDDDBDBBDDDDDBDDDDDB
BDDDDDDDDBDDBDDDDDDDDDDDB
BDDDDBBBBBDDBDDDDDDDDDDVB
BDDDDBDDDDDDBBBBBBBBBBBBB
BDDDDBDDDDDDDDDDDDDDDDDDB
BDDDDBBBBBBBBBBBBBBBBBBDB
BDDDDDDDDDDDDDDDDDDDDDDHB
BDDDDDDBBBBBBBBBBBBBBBBDB
BDDBBBDBDDDDDDDDDDDDDDDDB
BDDBVBDBDDDDDDDDDDDDDDDDB
BDDBDBBBDDDDDDDDDDDDDDDDB
BDDBDDDDDDDDDDDDDDDDDDDDB
BDDBBBBBBBBBBBBBBBBBBBBDB
BDDDDDDDDDDDDDBDDDDDDDDDB
BDDDDDDDDDDDDDBDDDDDDDDDB
BDBBBDDDDDDDDDBDDDDDDDDDB
BDBDDDDDDDDDDDBBBDDDDDDDB
BDBBBBBBBBBBDDDDBDDDDDDDB
BDDDDDDDDDDBDDDDBBBBBBDDB
BBBBBBBBBDDBDDDDBDDDDDDDB
BVDDDDDDBDVBDDDDBDDDDDDDB
BDDDDDDDBBBBDDDDBDDDDDDDB
BEDDDDDDDDDDDDDDBDDDDDDDB
BBBBBBBBBBBBBBBBBBBBBBBBB
