XXXXXXXXXXXXXXXXXXXXXXXXX
XDDDDDDDDDDDDDDDDDDDDDDDX
XXXXXXXXXXDXXXXXXXXDDDDDX
XDDDDDDDVXDXVDDDDDXDDDDDX
XDDDDDDDDXDXXDDDDDXDDDDDX
XDDDDDDDDXDDXDDDDDDDDDDDX
XDDDDXXXXXDDXDDDDDDDDDDVX
XDDDDXDDDDDDXXXXXXXXXXXXX
XDDDDXDDDDDDDDDDDDDDDDDDX
XDDDDXXXXXXXXXXXXXXXXXXDX
XDDDDDDDDDDDDDDDDDDDDDDHX
XDDDDDDXXXXXXXXXXXXXXXXDX
XDDXXXDXDDDDDDDDDDDDDDDDX
XDDXVXDXDDDDDDDDDDDDDDDDX
XDDXDXXXDDDDDDDDDDDDDDDDX
XDDXDDDDDDDDDDDDDDDDDDDDX
XDDXXXXXXXXXXXXXXXXXXXXDX
XDDDDDDDDDDDDDXDDDDDDDDDX
XDDDDDDDDDDDDDXDDDDDDDDDX
XDXXXDDDDDDDDDXDDDDDDDDDX
XDXDDDDDDDDDDDXXXDDDDDDDX
XDXXXXXXXXXXDDDDXDDDDDDDX
XDDDDDDDDDDXDDDDXXXXXXDDX
XXXXXXXXXDDXDDDDXDDDDDDDX
XVDDDDDDXDVXDDDDXDDDDDDDX
XDDDDDDDXXXXDDDDXDDDDDDDX
XEDDDDDDDDDDDDDDXDDDDDDDX
XXXXXXXXXXXXXXXXXXXXXXXXX
