X;X;X;X;X;X;X;X;X;X;X;X;X;X;X;X;X;X;X;X;X;X;X;X;X
X;D;D;D;D;D;D;D;D;D;D;D;D;D;D;D;D;D;D;D;D;D;D;D;X
X;X;X;X;X;X;X;X;X;X;D;X;X;X;X;X;X;X;X;D;D;D;D;D;X
X;D;D;D;D;D;D;D;V;X;D;X;V;D;D;D;D;D;X;D;D;D;D;D;X
X;D;D;D;D;D;D;D;D;X;D;X;X;D;D;D;D;D;X;D;D;D;D;D;X
X;D;D;D;D;D;D;D;D;X;D;D;X;D;D;D;D;D;D;D;D;D;D;D;X
X;D;D;D;D;X;X;X;X;X;D;D;X;D;D;D;D;D;D;D;D;D;D;V;X
X;D;D;D;D;X;D;D;D;D;D;D;X;X;X;X;X;X;X;X;X;X;X;X;X
X;D;D;D;D;X;D;D;D;D;D;D;D;D;D;D;D;D;D;D;D;D;D;D;X
X;D;D;D;D;X;X;X;X;X;X;X;X;X;X;X;X;X;X;X;X;X;X;D;X
X;D;D;D;D;D;D;D;D;D;D;D;D;D;D;D;D;D;D;D;D;D;D;H;X
X;D;D;D;D;D;D;X;X;X;X;X;X;X;X;X;X;X;X;X;X;X;X;D;X
X;D;D;X;X;X;D;X;D;D;D;D;D;D;D;D;D;D;D;D;D;D;D;D;X
X;D;D;X;V;X;D;X;D;D;D;D;D;D;D;D;D;D;D;D;D;D;D;D;X
X;D;D;X;D;X;X;X;D;D;D;D;D;D;D;D;D;D;D;D;D;D;D;D;X
X;D;D;X;D;D;D;D;D;D;D;D;D;D;D;D;D;D;D;D;D;D;D;D;X
X;D;D;X;X;X;X;X;X;X;X;X;X;X;X;X;X;X;X;X;X;X;X;D;X
X;D;D;D;D;D;D;D;D;D;D;D;D;D;X;D;D;D;D;D;D;D;D;D;X
X;D;D;D;D;D;D;D;D;D;D;D;D;D;X;D;D;D;D;D;D;D;D;D;X
X;D;X;X;X;D;D;D;D;D;D;D;D;D;X;D;D;D;D;D;D;D;D;D;X
X;D;X;D;D;D;D;D;D;D;D;D;D;D;X;X;X;D;D;D;D;D;D;D;X
X;D;X;X;X;X;X;X;X;X;X;X;D;D;D;D;X;D;D;D;D;D;D;D;X
X;D;D;D;D;D;D;D;D;D;D;X;D;D;D;D;X;X;X;X;X;X;D;D;X
X;X;X;X;X;X;X;X;X;D;D;X;D;D;D;D;X;D;D;D;D;D;D;D;X
X;V;D;D;D;D;D;D;X;D;V;X;D;D;D;D;X;D;D;D;D;D;D;D;X
X;D;D;D;D;D;D;D;X;X;X;X;D;D;D;D;X;D;D;D;D;D;D;D;X
X;E;D;D;D;D;D;D;D;D;D;D;D;D;D;D;X;D;D;D;D;D;D;D;X
X;X;X;X;X;X;X;X;X;X;X;X;X;X;X;X;X;X;X;X;X;X;X;X;X
