BBBBBBBBBBBBBBBBBBBBBBBBB
BDDDDDDDDDBBXXRRXXBDDDDDB
BDDDDDDDDDBBXRRRRXBDDDDDB
BDDDDDDDDDBBRRVVRRBDDDDDB
BDDDDDDDDDBDDDDDDEBDDDDDB
BDDDDDDDDDBRBBBBBBBDDDDDB
BDDDDDDDDDBDBDDDDDDDDDDDB
BDDDDDDDDDBDBBDDDDDDDDDDB
BDDDDDDDDDBDVBDDDDDDDDDDB
BDDDDDDDDDBDBBDDDDDDDDDDB
BDDDDDDDDDBDBDDDDDDDDDDDB
BDDDDDDDDDBDBDDDDDDDDDDDB
BDDDDDDDDDBDBDDDDDDDDDDDB
BDDDDDDDDDBDBDDDDDDDDDDDB
BDDDDDDDDDBDBDDDDDDDDDDDB
BDDDDDDDDDBDBDDDDDDDDDDDB
BDDDDDDDDDBDBDDDDDDDDDDDB
BDDDDDDDDDBDBDDDDDDDDDDDB
BDDDDDDDDDBDBDDDDDDDDDDDB
BDDDDDDDDDBDBDDDDDDDDDDDB
BDDDDDDDDDBDBDDDDDDDDDDDB
BDDDDDDDDDBDBDDDDDDDDDDDB
BDDDDDDDDDBDBDDDDDDDDDDDB
BDDDDDDDDDBDBDDDDDDDDDDDB
BDDDDDDDDDBDBDDDDDDDDDDDB
BDDDDDDDDDBDBDDDDDDDDDDDB
BDDDDDDDDDBHBDDDDDDDDDDDB
BBBBBBBBBBBBBBBBBBBBBBBBB
