XXXXXXXXXXXXXXXXXXXXXXXXX
XDDDDDDDDDXXOORROOXDDDDDX
XDDDDDDDDDXXORRRROXDDDDDX
XDDDDDDDDDXXRRVVRRXDDDDDX
XDDDDDDDDDXDDDDDDEXDDDDDX
XDDDDDDDDDXRXXXXXXXDDDDDX
XDDDDDDDDDXDXDDDDDDDDDDDX
XDDDDDDDDDXDXXDDDDDDDDDDX
XDDDDDDDDDXDVXDDDDDDDDDDX
XDDDDDDDDDXDXXDDDDDDDDDDX
XDDDDDDDDDXDXDDDDDDDDDDDX
XDDDDDDDDDXDXDDDDDDDDDDDX
XDDDDDDDDDXDXDDDDDDDDDDDX
XDDDDDDDDDXDXDDDDDDDDDDDX
XDDDDDDDDDXDXDDDDDDDDDDDX
XDDDDDDDDDXDXDDDDDDDDDDDX
XDDDDDDDDDXDXDDDDDDDDDDDX
XDDDDDDDDDXDXDDDDDDDDDDDX
XDDDDDDDDDXDXDDDDDDDDDDDX
XDDDDDDDDDXDXDDDDDDDDDDDX
XDDDDDDDDDXDXDDDDDDDDDDDX
XDDDDDDDDDXDXDDDDDDDDDDDX
XDDDDDDDDDXDXDDDDDDDDDDDX
XDDDDDDDDDXDXDDDDDDDDDDDX
XDDDDDDDDDXDXDDDDDDDDDDDX
XDDDDDDDDDXDXDDDDDDDDDDDX
XDDDDDDDDDXHXDDDDDDDDDDDX
XXXXXXXXXXXXXXXXXXXXXXXXX
