XXXXXXXXXXXXXXXXXXXXXXXXX
XOOOOOOOOOOOMOOOOOOOOOOHX
XOOOOOOOOOOOOOOOOOOOOOOOX
XOOOOOORRRRRRRRRRROOOOOOX
XOOOOOODDDDDDDDDDDOOOOOOX
XOOOOOOOOOOOOOOOOOOOOOOOX
XOOOOOOOOOOOOOOOOOOOOOOOX
XXXXXXXXXXXXXXXXXXXXXXXXX
XOOOOOOOOOOOMOOOOOOOOOOOX
XOOOOOOOOOOOOOOOOOOOOOOOX
XOOOOOOOOOOOOOOOOOOOOOOOX
XOOOOOOOOOOOOOOOOOOOOOOOX
XOOOOOORRRRRRRRRRROOOOOOX
XOOOOOODDDDDDDDDDDOOOOOOX
XOOOOOOOOOOOOOOOOOOOOOOOX
XOOOOOOOOOOOOOOOOOOOOOOOX
XOOOOOOOOOOOOOOOOOOOOOOOX
XXXXXXXXXXXXXXXXXXXXXXXXX
XOOOOOOOOOOOMOOOOOOOOOOOX
XOOOOOOOOOOOOOOOOOOOOOOOX
XOOOOOOOOOOOOOOOOOOOOOOOX
XOORRRROOOOOOOOOOORRRROOX
XOODDDDOOOOOOOOOOODDDDOOX
XOOOOOOOOOOOOOOOOOOOOOOOX
XOOOOOOOOOOOOOOOOOOOOOOOX
XOOOOOOOOOOOOOOOOOOOOOOOX
XEOOOOOOOOOOOOOOOOOOOOOOX
XXXXXXXXXXXXXXXXXXXXXXXXX
