GGGGGGGGGGGGGGGGGGGGGGGGG
GXXXXXXXXXXXKXXXXXXXXXXHG
GXXXXXXXXXXXXXXXXXXXXXXXG
GXXXXXXRRRRRRRRRRRXXXXXXG
GXXXXXXDDDDDDDDDDDXXXXXXG
GXXXXXXXXXXXXXXXXXXXXXXXG
GXXXXXXXXXXXXXXXXXXXXXXXG
GGGGGGGGGGGGGGGGGGGGGGGGG
GXXXXXXXXXXXKXXXXXXXXXXXG
GXXXXXXXXXXXXXXXXXXXXXXXG
GXXXXXXXXXXXXXXXXXXXXXXXG
GXXXXXXXXXXXXXXXXXXXXXXXG
GXXXXXXRRRRRRRRRRRXXXXXXG
GXXXXXXDDDDDDDDDDDXXXXXXG
GXXXXXXXXXXXXXXXXXXXXXXXG
GXXXXXXXXXXXXXXXXXXXXXXXG
GXXXXXXXXXXXXXXXXXXXXXXXG
GGGGGGGGGGGGGGGGGGGGGGGGG
GXXXXXXXXXXXKXXXXXXXXXXXG
GXXXXXXXXXXXXXXXXXXXXXXXG
GXXXXXXXXXXXXXXXXXXXXXXXG
GXXRRRRXXXXXXXXXXXRRRRXXG
GXXDDDDXXXXXXXXXXXDDDDXXG
GXXXXXXXXXXXXXXXXXXXXXXXG
GXXXXXXXXXXXXXXXXXXXXXXXG
GXXXXXXXXXXXXXXXXXXXXXXXG
GEXXXXXXXXXXXXXXXXXXXXXXG
GGGGGGGGGGGGGGGGGGGGGGGGG
