XXXXXXXXXXXXXXXXXXXXXXXXX
XDDDDDDDDDDDDDDDDDDDDDOMX
XDDDDDDDDDDDDDDDDDDDDDOOX
XDDDDDDDDDDDDDDDDDDDDDDDX
XDDDDDDDDDDDDDDDDDDDDDDDX
XDDDVVVVVDDDDDDDVVVVVDDDX
XDDDRRRRRDDDDDDDRRRRRDDDX
XDDDDDDDDDDDDDDDDDDDDDDDX
XDDDDOOMDDDDDDDDDMOODDDDX
XDDDDOOODDDDDDDDDOOODDDDX
XDDDDOOODDDDDDDDDOOODDDDX
XDDDDDDDDDDDDDDDDDDDDDDDX
XDDDDDDDDDDDDDDDDDDDDDDDX
XDDDDDDDDDDDDDDDDDDDDDDDX
XDDDDDDDDDDDDDDDDDDDDDDDX
XDDDDDDDDDDDDDDDDDDDDDDDX
XDDDDDDDDDDDEDDDDDDDDDDDX
XDDDDDDDRRRRRRRRRDDDDDDDX
XDDDDDDDDDDDDDDDDDDDDDDDX
XDDDDDDDOOOOMOOOODDDDDDDX
XDDDDDDDXOOOOOOOXDDDDDDDX
XDDDDDDDDXVOOOVXDDDDDDDDX
XDDDDDDDDDXVVVXDDDDDDDDDX
XDDDDDDDDDDXXXDDDDDDDDDDX
XDDDDDDDDDDDDDDDDDDDDDDDX
XOMDDDDDDDDDDDDDDDDDDDDDX
XOODDDDDDDDDDDDDDDDDDDDHX
XXXXXXXXXXXXXXXXXXXXXXXXX
