GGGGGGGGGGGGGGGGGGGGGGGGG
GDDDDDDDDDDDDDDDDDDDDDXKG
GDDDDDDDDDDDDDDDDDDDDDXXG
GDDDDDDDDDDDDDDDDDDDDDDDG
GDDDDDDDDDDDDDDDDDDDDDDDG
GDDDVVVVVDDDDDDDVVVVVDDDG
GDDDRRRRRDDDDDDDRRRRRDDDG
GDDDDDDDDDDDDDDDDDDDDDDDG
GDDDDXXKDDDDDDDDDKXXDDDDG
GDDDDXXXDDDDDDDDDXXXDDDDG
GDDDDXXXDDDDDDDDDXXXDDDDG
GDDDDDDDDDDDDDDDDDDDDDDDG
GDDDDDDDDDDDDDDDDDDDDDDDG
GDDDDDDDDDDDDDDDDDDDDDDDG
GDDDDDDDDDDDDDDDDDDDDDDDG
GDDDDDDDDDDDDDDDDDDDDDDDG
GDDDDDDDDDDDEDDDDDDDDDDDG
GDDDDDDDRRRRRRRRRDDDDDDDG
GDDDDDDDDDDDDDDDDDDDDDDDG
GDDDDDDDXXXXKXXXXDDDDDDDG
GDDDDDDDGXXXXXXXGDDDDDDDG
GDDDDDDDDGVXXXVGDDDDDDDDG
GDDDDDDDDDGVVVGDDDDDDDDDG
GDDDDDDDDDDGGGDDDDDDDDDDG
GDDDDDDDDDDDDDDDDDDDDDDDG
GXKDDDDDDDDDDDDDDDDDDDDDG
GXXDDDDDDDDDDDDDDDDDDDDHG
GGGGGGGGGGGGGGGGGGGGGGGGG
